6 10
P P P P P P
W W P W W W
P P P P P P
P W W W W P
P P P P P P
W W P W W W
P P P P P P
P P P P P P
W W W W P W
P P P P P P
2 1
3 1
4 1
3 2
5 9
4 10
5 10
6 10