6 7
P P P P P P
M P M P M P
P P P M M P
P P P P P P
M P M P M M
P P P P P P
P P P P P P
1 3
1 5
2 2
2 4
6 2
6 4
7 1
7 3