6 10
P P P P P P
M P M P M P
P P P M M P
P P P P P P
M M M P M M
M M P P P M
M P P P P M
V BV V P V V
M P M P M M
P P P P P P
3 1
5 1
2 2
4 2
2 9
4 9
1 10
3 10