6 7
P P P P P P
F P P F P P
P P P P P P
P F P P P F
P P P P F P
F P P P P P
P P P P P P
1 2
2 3
1 4
2 4
7 2
6 3
7 4
7 6