6 10 
P P P P P P
F P P F P P
P P P P P P
P F P P P F
P P P P F P
P P F P P P
F P P P P P
P F F P P P
F P P P P P
P P P P P P
2 1
3 2
4 1
4 2
2 10
3 9
4 10
6 10