6 7
P P P P P P
W W P W W W
P P P P P P
P W W W W P
P P P P P P
W W W W P W
P P P P P P
1 2
1 3
1 4
2 3
6 5
7 4
7 5
7 6