6 10
F P P P P P
P P P P F F
P F F P F P
P P P P P P 
BR R R BR R BR
P F P P F P
P F F P P P
P F F P F F
P P P P P P
P F F P P P
P P P P F F
2 2
3 1
4 2
5 1
1 9
2 10
4 10
6 9